FFFFFFFFFFFFF
F.F.F...F...F
F...F.F.F.F.F
FFF...F.FVF.F
F..VF.F.F.F.F
F.F.F.F...F.F
F.F.F.FFFFFVF
FKF.F.F.....F
FFFFFFFLFFFFF
