FFFF.FFFFFFFF
F.VFFF......F
FF.....FFFFVF
.FFFFF.FFFF.F
.F.V...FFFF.F
FFFFFF.F....F
F......FVFFFF
F.FFF..F...KF
FLF.FFFFFFFFF
