FFFFFFFFFFFFF
F...........F
F.F.FFFFFFF.F
F.F.F...K...F
F.FVFFFFFFFFF
F.F...F..V..F
F.FFF.F.FFF.F
F...F.V.F...L
FFFFFFFFFFFFF
